##........
....#.....
.#..##....
.##.#.....
.........#
..#.......
.........#
.#.#......
.#........
...##..###
