........#.
...##..##.
..........
...#.#....
.......#..
#.##......
#.........
..........
##....#...
.#..#.###.
