..........
....#.....
.#..#.#...
.#........
..........
...###..#.
##........
#...##.#..
..#.......
.....####.
