.##...#...
..........
#.....##..
.......#..
.........#
.#........
.......#..
.......#..
#.#....#.#
#.###....#
