##...#..#.
.....#....
..........
###.......
.....#....
.....##...
#........#
#.#....#..
.......##.
.....#..#.
