.###....##
.....#..##
..##......
........##
......#...
#..#..#...
..........
..........
..........
..###..#..
