........##
......#...
..........
.#...#....
.......##.
.#........
....##..#.
.##..#.##.
..#.....#.
.....##...
