..........
#..#....#.
#.##.#....
..........
..........
..#...##.#
..##.....#
..#..#.#.#
.......#..
.....#....
