....##.#..
.....#.#.#
...#......
...#......
..##......
......##..
..#......#
..#.#..#..
#......#..
.......#..
