#...###...
#.......#.
#.........
....#.....
#.........
...##.....
#.......#.
........#.
..........
##.####...
