.....##...
.........#
.....#....
.....#...#
#.#......#
..........
...#......
...##....#
.#....#...
###..##...
