........#.
##.#....#.
#.........
#.#...#.#.
..........
..........
#.........
#..#......
#..##.#...
......#.##
