..##......
..#...#...
#........#
#.##......
..........
#...##....
....#..##.
.#..#.....
......#...
......##..
