.....#.#..
..#....#.#
..#...##.#
..#.#.....
..........
#.........
..........
..#.##..#.
..#.....##
.....#....
