#.#.......
....#.#...
......##..
.#........
.........#
##..###..#
..........
........#.
........##
..##....#.
