.#..##.#..
..........
....#.....
.#..##....
..........
.##.##.##.
.......##.
.....#....
...#......
...##.....
