#...##.#..
.....#.#..
...#...#..
...#.#....
.........#
...##....#
......#..#
.........#
.##...#...
..........
