#..#..##..
##....##..
..........
.##...#...
..........
........#.
##........
..........
.#.#..##..
.#....#...
