...#....##
..........
..........
......#.#.
......#.##
#.......#.
..........
.#....#.##
.#..#...#.
...##.#...
