#.##......
#.#......#
..........
......#...
..........
..........
#.....###.
...##..#..
.#.......#
##.....#.#
