..##......
..#...#...
.........#
.###.#.#..
.....#....
.......#..
#.........
#.......##
..##......
..##......
