#.....#...
#.......#.
........#.
....#.....
........#.
#.##....##
..........
.##...#...
..#..##.#.
......#...
