..........
...#.....#
##........
#........#
..##......
.......###
.##.......
..........
..##...#.#
..##.....#
