....#.....
#...##....
..........
.#...###.#
...#.....#
.###......
..........
..##.#..#.
..........
......##..
