..#....###
..........
....#.###.
......#...
..##......
..........
.##.......
....##...#
..........
###..#....
