.#.....##.
.....#....
..........
#...#.....
...##.....
..........
.....#..##
..........
.###.#..#.
.#...#.##.
