..........
#.....#.#.
#.#...#.#.
........#.
..........
..#.#.....
....#.##..
.#..#.....
.##.......
.#...#...#
