.....##...
.#.#..#...
..........
...#......
#..#.##...
#.........
#....#....
.....#.#..
.#.....###
.....#....
