...##.....
......#...
.....##..#
...#......
..........
...#.....#
.#.......#
.#...##...
.#.#....#.
...###....
