#.........
##........
.........#
......#..#
##.##.#...
...#..#..#
#..#......
..........
.....#..#.
#....#....
