.........#
#...#.....
###.#.....
....#.....
.##......#
.....###..
.#.......#
.#.......#
....#.....
.........#
