..#.......
.........#
.####.....
.......#..
##........
.....##...
##........
..........
#.......##
..###....#
