...#......
##.#..##..
..........
....#...#.
......#...
........#.
....#...#.
.#..##..#.
.#........
##.......#
