.........#
..........
.#...#....
.#...###.#
.........#
..........
#...#.....
..........
#....##..#
#.#...#.##
