.....##.#.
..#..#....
#.........
#....##...
...#....#.
...##.....
.#........
.......##.
........##
..##......
