....##....
.......##.
.###......
.......##.
#....#....
.....##...
.#........
.....#....
..........
...#..####
