.......##.
.....#....
.......#..
##.##..##.
#.........
.........#
....#.....
.##.......
..##...##.
#.........
