.....#....
.##.......
.......#..
.......#..
..##.#.#..
..........
..#...#...
.....##.#.
#.##.#....
#..#......
