...##....#
...##.....
.#....#..#
.....##...
...#......
...#......
#.........
#.##....#.
#.......#.
..#.......
