.....#..#.
.#.....##.
##.#......
#.........
.....##.##
..........
....#...#.
..........
.#....##..
.##.......
