..###...##
..........
#.......##
...##...#.
.#........
.........#
..........
.##..##..#
......##..
..........
