...##.....
#.....###.
##.#......
#.......#.
.....#..#.
.#...#....
.........#
..........
#...###...
..........
