...#......
#.....#...
#.....#...
#.#.......
..##..#..#
..........
....##.##.
##...#....
.....#...#
..........
