#.....#..#
##........
...##.....
........##
..##.#....
...#.....#
.....#...#
.........#
.....##..#
..........
