........##
#.#.#...##
..#.......
.....#....
.....#....
.......##.
.#.....#..
.#.......#
.#....#..#
....#.....
