.........#
.......#..
#.##......
#.........
.......#..
...###....
#......#..
#..#.###..
...#......
...#....#.
