......###.
..##......
..#.....#.
....#...#.
..#...#...
......#.#.
........##
........#.
..........
##.....#.#
