#....#..##
..#..#....
#....#..##
........#.
..........
..#.......
..##......
..#...#...
......#...
#.......##
