..###....#
...#..##.#
......#..#
..........
......#...
...#.....#
.......#..
.....#.#.#
..##.#....
..........
