..........
....#.##..
.#..#.....
##.....#..
...#......
..........
.....##...
..##..#.#.
.##.......
....#.##..
