##..##.#..
.#...#.#..
.#.#......
...##.....
..........
....#...#.
....#.....
.#........
.........#
#.#......#
