#.......#.
..#..#....
....##....
.......#..
...##.....
..........
.#.#.....#
.#.#.....#
.#......##
....##....
