...##...#.
....#.....
........#.
#...#...#.
........##
..##......
.....##...
##.......#
#.....##..
..........
