..........
....#.....
#.....#..#
#...#.....
...##...##
......#.##
.#.#......
.#.#......
.......#..
......##..
