#.###...#.
#..#..#.#.
#.........
..........
.##.......
..........
#.##.#....
...#......
.......#..
#......#..
