....#...##
#.....#...
..##......
...#.....#
.......#..
.......##.
........#.
..........
..#..#..#.
.##..#..#.
