..###...##
..#.......
.....##...
.##..#....
........#.
...#.#....
..........
#.........
......##..
##.....#..
