..........
...#.#..##
...#.##...
.#......#.
###.......
......#.#.
...#......
...#...#..
...#...#..
.#........
