..........
..###.#...
#........#
..........
..........
.....#..##
.....#..#.
##........
#.........
#.##..##.#
