...###....
.......#..
...##..##.
##..#...#.
..........
.##.#.....
....#..#..
.........#
#.........
..#.......
