....#....#
......##..
.......#.#
....#.....
......###.
..##......
..#..##...
..#.......
....#...#.
....#...#.
