....###.##
........#.
...##.#...
#.........
..#.......
..#.....#.
......###.
#..#......
#.........
..#.......
