....#..#.#
...##.##..
##..#.....
......#...
......#...
..#.......
.##.#...#.
........#.
.#..#.....
..........
