....#.....
....#.#...
#.#...##..
..#......#
..........
.......#..
.....###..
#.#.......
..#.##....
#.#.......
