##.....#..
...#......
.#.#.##...
..........
....###...
.#...#...#
..........
.....###..
...#......
..##......
