.##..#...#
..........
.#....#...
##..#.#...
..........
....##...#
....#....#
.#.......#
......#..#
......#...
