.........#
....#.#..#
.#........
.#.##.....
.#........
.........#
....##.#.#
.....#....
.....#.##.
#......#..
