#.#.......
..##......
#.........
#........#
...##....#
.........#
..#.#....#
..........
...#.###..
##........
