.......#..
.##.......
.....#....
.....#..##
........#.
...###..#.
.#........
......#...
#...#...#.
....##..#.
