......#...
.###..#...
...#......
##......#.
..........
#.#...#...
#.........
#......#..
..#..#....
.##..#....
