.....#....
........##
....#.....
#.#.....#.
#.#.#.#.#.
#.#...#.#.
........#.
..........
..........
......##.#
