..##...#.#
.......#..
.#.##..##.
.#........
..........
.......#..
....##....
..#..#...#
..........
.....###..
