.###.#....
.....#.#..
.........#
#...#.....
..#.##.#..
.##.......
..#.##....
..........
.##.......
..........
