..#.#.....
.......###
....#....#
....#..#..
.#.....##.
..........
..........
....#..#.#
....##...#
##........
