......##..
.......#..
.##..#.#.#
.....#....
..#..#....
..........
......#...
#..#..#...
#........#
#...##....
