....##..#.
.......##.
.##.##....
..#......#
.......#..
.......#..
#...#.....
..........
.......###
.#.......#
