.........#
##.....#..
.....#....
.#........
.#.....#.#
.........#
###.......
........##
###......#
.#........
