#..#.#....
##.#.#....
.#........
......#...
........#.
#...##....
#...#...#.
..........
..#...###.
..........
