...#.##...
.###......
.........#
...##....#
#......#..
##........
...#......
.....#....
..##.....#
..#.......
