#..#......
.......###
.........#
..........
..##......
#.#.......
#.....#..#
..#...#..#
..........
#....###..
