.##..#....
..........
#......#..
.........#
...##...##
...#......
.....#...#
.....#....
.##....##.
......##..
