#.........
#..###....
.....#....
#.......#.
....##..##
#.........
.....#....
.#........
........##
....##...#
