.##.......
......#...
..........
...##...#.
......#...
##.......#
#..#.##...
...#.#..#.
........#.
.......##.
