.#....#...
.#....##..
....#.....
....##.##.
..#.....##
..........
.#........
...##.....
##........
....#.#...
