...##..#..
.......#..
..........
.......#..
....#..#.#
....##....
#......#..
....#.....
.#......#.
.##....###
