..........
#.##.#...#
#.#..#....
.....#....
#.........
#.#...#...
........##
..........
.......##.
..#....##.
