..........
.##.#.....
..#....#..
.....#.#..
..........
.##.....#.
....##.##.
.......#..
..#.#....#
........##
