.......#..
##....##..
.........#
....#..#.#
.........#
..##..##.#
...#......
.#......##
..........
.........#
