.##...##.#
......#..#
......#...
..#......#
#.#...#...
......#...
......#...
..#.......
#.#....#..
..#.......
