.#.....###
.#.#......
.........#
........##
..##.....#
..........
.#...##...
.........#
.###.#....
..........
