.###..#..#
.....###.#
...#......
...#.#....
..........
..#.......
.....##...
#.........
........#.
....#...##
