......#...
#...#.....
#...#.....
..#.#....#
#.........
##...#....
..........
##........
...#...##.
...#...##.
