.##.......
.#....#...
...##.##..
..........
...#...#..
.#........
.#........
......##..
###.......
..#....#.#
