......#..#
.###.....#
..#.......
.......#..
....#.....
..........
.###.##...
..........
##.#......
#..#....#.
