....#.....
....#....#
.......#..
....#.##..
##.....#..
..........
.......#..
#..#...#.#
#.........
#...###...
