.#.#......
.#.#.....#
.....#...#
....##..##
#.#.......
..#.......
......##..
#......#..
..........
....#.#...
