.#...###..
.##....#.#
.....#....
..........
...#..###.
...#......
.....#....
.#...#....
.........#
.....#...#
