##.##.#..#
##..#.....
.........#
.........#
..#..##..#
..........
#.......##
..........
...##.....
..........
