.....##...
.........#
..#.......
....#..#..
.##...##..
.......#..
#.........
#.#.......
..#.....#.
..#.#..##.
