.....#..#.
##........
#.........
...#...###
..##....#.
......#...
..#...#..#
.........#
##...#....
..........
